[2, 1, 1, 1, 1, 1, 4, 57, 11, 115, 21, 17, 116, 121, 44, 17, 153, 35, 13, 15, 64, 15, 63, 103, 11, 92, 60, 13, 11, 247]
[2, 4, 54, 3, 11, 55, 24, 23, 22, 5, 42, 20, 197, 22, 155, 19, 70, 8, 99, 117, 24, 4, 175, 30, 37, 23, 44, 28, 10, 1, 1]
[2, 1, 1, 1, 1, 3, 2, 58, 8, 65, 45, 1, 139, 21, 38, 124, 19, 172, 16, 78, 15, 25, 2, 8, 17, 110, 61, 68, 132, 11, 97, 42, 242, 8]
[2, 1, 1, 4, 5, 53, 12, 86, 32, 48, 124, 6, 18, 34, 25, 124, 86, 27, 13, 38, 21, 8, 2, 2]
[2, 1, 3, 2, 54, 10, 18, 64, 36, 12, 42, 158, 10, 32]
[1, 4, 55, 4, 19, 19, 140, 14, 171, 18, 36, 15, 2, 4, 23, 25, 3, 1]
[2, 17, 24, 8, 2, 71, 38, 15, 66, 8, 32, 39, 91, 32, 105, 66, 15, 156, 42, 15, 31, 5, 1, 2, 16, 17, 56, 35, 32, 77, 85, 31, 28, 10, 16, 29, 42, 115, 1, 2]
[1, 1, 1, 4, 53, 3, 23, 62, 39, 20, 42, 12, 105, 30, 11, 170, 156, 12, 26, 76, 46, 15, 77, 8]
[2, 4, 7, 50, 5, 7, 17, 56, 21, 1, 117, 15, 32, 56, 64, 16, 18, 39, 92, 19, 17, 157, 18, 1, 6, 10, 55, 19, 15, 76, 97, 19, 1, 1, 1, 27, 21, 61]
[2, 1, 4, 5, 50, 11, 58, 55, 26, 7, 18, 67, 11, 0, 12, 161, 11, 4, 11, 1, 22, 34, 28, 18, 15, 1, 8, 9, 58, 4, 17, 4, 3, 32, 68, 1, 2, 38, 7, 44, 25, 6, 1, 33, 20, 14, 34, 14, 3, 1]

