[2, 1, 1, 1, 1, 4, 54, 12, 51, 10, 44, 26, 129, 91, 13, 2, 70, 32, 33, 160, 13, 13, 63, 26, 66, 16, 38]
1, 1, 1, 1, 1, 3, 2, 56, 14, 13, 51, 9, 1, 1, 1, 31, 4, 22, 171, 63, 24, 9, 70, 58, 14, 42, 111, 9, 137, 17, 13, 82, 106, 2, 1]
[2, 1, 3, 2, 6, 48, 13, 14, 43, 22, 59, 13, 156, 61, 21, 70, 22, 11, 3, 82, 21, 38, 24, 20, 79, 52, 10, 21, 6, 83, 27, 11]
[2, 3, 2, 7, 49, 40, 11, 29, 45, 16, 5, 19, 42, 19, 3, 108, 62, 38, 3, 13, 78, 41, 10, 17, 3, 4, 100, 50, 3, 36, 111, 15, 94, 63, 10, 1]
[2, 3, 2, 7, 56, 50, 26, 27, 60, 67, 18, 16, 30, 39, 15, 114, 61, 38, 4, 101, 11, 151, 17, 24, 90, 26, 3, 45, 111, 11]
[2, 3, 2, 5, 52, 56, 5, 11, 69, 41, 17, 4, 36, 10, 60, 159, 11, 68, 39, 1, 154, 8, 16, 56, 109, 11, 11, 1]
[1, 3, 2, 4, 56, 14, 27, 32, 72, 8, 13, 16, 102, 23, 1, 20, 14, 3, 6, 94, 19, 97, 11, 36, 1]
[2, 1, 4, 5, 30, 31, 57, 12, 82, 26, 23, 2, 55, 44, 11, 78, 58, 13, 211, 5, 3, 53, 18, 33, 1]
[2, 1, 1, 1, 3, 2, 4, 58, 12, 6, 20, 43, 14, 29, 30, 25, 213, 12, 87, 4, 157, 21, 20, 173, 9, 23, 117, 24, 126, 107, 3, 29]
[2, 1, 1, 1, 1, 3, 2, 5, 51, 8, 59, 7, 42, 31, 12, 66, 107, 11, 40, 125, 23, 82, 12, 144, 20, 11, 115, 126, 8, 61, 79, 68, 19]

