[2, 1, 4, 6, 57, 54, 20, 19, 114, 15, 9, 33, 6, 169, 43, 39, 37, 1]
[2, 1, 1, 1, 1, 1, 1, 1, 1, 1, 3, 2, 4, 2, 36, 18, 14, 28, 21, 27, 23, 53, 31, 3, 81, 112, 14, 4, 1, 1, 1]
[2, 34, 18, 34, 37, 21, 31, 40, 2, 148, 22, 11, 5, 3, 3, 19, 14, 15, 49, 27, 24, 1, 8, 6, 97, 25, 60, 20, 123, 15, 2, 10, 36, 42, 44, 22, 78, 15, 8]
[2, 1, 1, 4, 54, 8, 11, 38, 2, 3, 1, 1, 1, 1, 1, 1]
[2, 3, 2, 5, 51, 56, 24, 98, 18, 33, 20, 124, 61, 26, 14, 96, 11, 22, 126, 105, 23, 33, 17, 6, 79, 61, 72, 2, 2, 1, 82, 3]
[2, 1, 3, 2, 53, 35, 26, 42, 12, 39, 18, 10, 2, 192, 137, 40, 49, 49, 13, 11, 66, 65, 74, 1]
[2, 1, 1, 1, 4, 6, 53, 42, 14, 14, 102, 26, 2, 31, 1, 1]
[2, 1, 3, 2, 54, 12, 7, 43, 20, 3, 1, 2, 11, 57, 23, 176, 18, 144, 25, 118, 46, 4, 106, 4, 63, 65, 66, 48, 9, 29, 47, 81, 34, 62, 62, 51]
[2, 1, 3, 2, 54, 12, 7, 53, 21, 7, 4, 56, 137, 18, 4, 43, 63, 15, 17, 210, 36, 12, 147, 24, 23, 90, 56, 20, 2, 1]
[2, 1, 1, 1, 1, 1, 1, 3, 2, 4, 2, 51, 17, 70, 46, 9, 5, 96, 15, 5, 174, 16, 1, 1, 


