[2, 1, 1, 3, 2, 4, 2, 43, 34, 17, 15, 41, 3, 5, 1, 33, 64, 9, 71, 68, 26, 32, 24, 4, 4, 26, 6, 201, 165, 19, 8]
[2, 1, 4, 4, 17, 25, 39, 3, 34, 14, 90, 59, 31, 10, 39, 186, 16, 36, 61, 35, 17, 17, 186, 12, 6]
[2, 1, 1, 4, 11, 23, 8, 76, 3, 22, 26, 165, 12, 9, 72, 21, 148, 142, 1]
[1, 1, 1, 1, 1, 4, 7, 51, 6, 27, 35, 40, 1, 59, 109, 4, 14, 185, 1, 7, 81, 65, 50, 11, 47, 140, 4, 33, 65, 188]
[2, 1, 1, 3, 2, 8, 56, 8, 36, 43, 5, 46, 25, 212, 12, 33, 15, 8, 154, 9, 13, 16, 150, 2, 10, 46, 22, 3]
[2, 1, 1, 1, 3, 2, 12, 21, 6, 9, 97, 22, 14, 29, 117, 14, 75, 2, 1, 1, 8, 47, 89, 8, 139, 42, 3, 13, 33, 225, 1]
[2, 1, 1, 3, 2, 4, 27, 35, 4, 44, 21, 70, 37, 13, 75, 10, 7, 54, 5, 1, 4, 61, 22, 97, 24, 17, 197, 30, 144, 88]
[1, 1, 1, 1, 3, 2, 7, 15, 19, 47, 25, 11, 14, 21, 36, 50, 13, 39, 227, 19, 11, 30, 154, 21, 10, 133, 55]
[1, 1, 1, 4, 11, 19, 10, 22, 23, 5, 57, 14, 156, 3, 8, 5, 65, 6, 14, 1, 39, 2, 149, 12, 221, 19, 6]
[2, 1, 3, 2, 14, 15, 3, 1, 1, 1, 1]

