[1, 4, 63, 18, 27, 5, 16, 56, 14, 18, 5, 136, 42, 17, 1, 2, 2, 32, 1, 21, 35, 82, 11, 11, 11, 16, 4, 251, 11, 1, 1]
[1, 4, 57, 4, 39, 3, 1, 1, 1, 1, 1]
[1, 1, 2, 59, 19, 33, 25, 4, 112, 1, 1, 1, 1]
[1, 4, 39, 56, 29, 16, 35, 1, 1, 1]
[2, 1, 4, 2, 39, 22, 10, 32, 21, 28, 13, 22, 31, 49, 1, 17, 22, 37, 1, 25, 193, 32, 1, 2]
[2, 4, 43, 22, 4, 10, 17, 40, 17, 52, 26, 2, 2, 1, 1]
[2, 4, 2, 24, 5, 24, 34, 30, 58, 4, 93, 37, 4, 17, 150, 59, 24, 12, 12, 12, 28, 3, 1, 1, 2]
[2, 4, 57, 10, 34, 19, 75, 58, 47, 16, 34, 11, 1, 1, 1]
[1, 4, 41, 40, 32, 21, 9, 38, 18, 43, 18, 2, 1, 31, 1, 1, 4, 28, 1, 1, 1, 1]
[2, 4, 36, 46, 17, 23, 36, 11, 55, 27, 68, 22, 19, 2, 2, 1, 1, 1]


