[1, 1, 1, 1, 1, 1, 1, 4, 5, 52, 11, 39, 125, 23, 16, 12, 8, 53, 8, 110, 157, 2, 30, 22, 7, 19, 1]
[2, 1, 1, 4, 60, 2, 16, 12, 33, 17, 13, 93, 10, 15, 15, 24, 38, 7, 197, 40, 2, 1, 1, 1, 1]
[2, 1, 4, 55, 13, 8, 36, 47, 15, 16, 34, 13, 52, 2, 1, 1, 13, 111, 18, 1, 1]
[2, 1, 1, 3, 2, 57, 17, 47, 19, 18, 61, 25, 13, 22, 28, 22, 28, 2, 26, 132, 18, 7, 25, 40, 15, 1]
[2, 4, 6, 56, 12, 29, 43]
[2, 3, 2, 59, 14, 40, 49, 7, 16, 112, 25, 28, 6, 11, 16, 1, 2, 1]
[2, 1, 1, 1, 4, 8, 51, 20, 15, 63, 20, 38, 21, 162, 8, 16, 28, 10, 10, 125, 6, 3, 2, 1, 1, 1, 1]
[2, 1, 1, 4, 50, 6, 31, 40, 49, 11, 1, 1, 37]
[2, 1, 1, 1, 4, 55, 11, 14, 33, 1, 1, 1]
[1, 3, 2, 6, 56, 10, 3, 63, 17, 38, 38, 191, 65, 14, 1, 85, 22, 37, 22, 9, 20, 53, 66, 30, 23, 4, 31, 28, 31, 50, 19, 30, 86, 8, 46, 19, 39, 1, 1]

