[2, 1, 1, 1, 1, 3, 2, 9, 47, 22, 30, 24, 19, 11, 179, 14, 19, 38, 19, 49, 47, 6, 16, 50, 10, 22, 3, 119, 127, 24, 11, 43, 17, 5, 155, 12, 191, 10, 17, 216, 52]
[1, 1, 1, 1, 1, 4, 65, 22, 16, 6, 9, 19, 45, 26, 26, 11, 14, 142, 63, 23, 22, 7, 119, 19, 18, 14, 5, 57, 14, 2, 62, 142, 40, 39, 6, 38, 50, 1]
[2, 1, 1, 1, 1, 4, 10, 51, 16, 17, 25, 18, 10, 41, 29, 8, 7, 231, 19, 90, 28, 12, 8, 19, 40, 39, 13, 19, 64, 1, 1]
[2, 1, 1, 4, 9, 62, 12, 26, 22, 3, 10, 2, 13, 4, 71, 10, 6, 244, 22, 15, 73, 43, 13, 1, 1, 1, 1, 1, 61, 18, 21, 4, 13, 26, 1]
[2, 1, 1, 1, 1, 3, 2, 59, 7, 5, 41, 28, 9, 148, 22, 27, 25, 87, 63, 22, 55, 3, 22, 22, 174, 75, 7, 3, 5, 8, 9, 3, 11, 7, 50, 49, 14, 78, 11, 95, 44, 9, 79, 130, 60, 22, 84]
[2, 1, 1, 1, 3, 2, 62, 21, 1, 1, 1, 4, 14, 23, 86, 61, 26, 9, 82, 37, 30, 12, 20, 1, 1, 69, 15, 89, 145, 5, 4, 54, 17, 7, 85, 17, 36, 97, 10, 30, 31, 34, 1]
[2, 1, 1, 1, 1, 1, 4, 11, 57, 17, 40, 3, 1, 16, 14, 138, 26, 14, 2, 1]
[2, 1, 1, 1, 4, 10, 52, 19, 18, 22, 135, 22, 28, 62, 26, 22, 22, 86, 9, 40]
[2, 3, 2, 4, 35, 60, 9, 15, 15, 16, 9, 18, 19, 51, 26, 55, 2, 1]
[2, 1, 1, 3, 2, 4, 61, 14, 24, 32, 15, 12, 15, 196, 20, 79, 35, 11, 57, 17, 1, 280, 2, 5, 54, 43, 21, 34, 19, 72, 75, 10, 1, 1, 1, 1, 1, 1, 2, 9, 43, 24, 1, 1, 1, 1]



