[10, 1, 32, 37, 14, 9, 52, 18, 138, 10, 154, 21, 119, 46, 12, 1, 1, 60, 8, 3, 4, 61, 25, 236, 43, 134, 1]
[11, 1, 1, 1, 65, 13, 12, 26, 65, 83, 72, 38, 17, 30, 130, 29, 12, 20, 138, 44, 41, 41, 27, 1, 22, 56, 2, 3, 54, 15, 13, 7, 392, 22, 6, 142, 52, 1]
[10, 1, 2, 38, 25, 15, 44, 28, 21, 35, 57, 52, 6, 28, 37, 12, 69, 8, 185, 39, 149, 33, 19, 88, 65, 39, 13, 121, 73, 75]
[10, 1, 1, 1, 1, 1, 27, 54, 22, 15, 7, 104, 13, 167, 6, 10, 32, 165, 19, 4, 44, 6, 22, 113, 91, 12]
[11, 38, 22, 38, 41, 23, 11, 53, 27, 6, 67, 116, 17, 64, 129, 4, 25, 12, 59, 63, 23, 11, 8, 49, 12, 37, 31, 3, 29, 1]
[10, 1, 1, 1, 2, 74, 21, 57, 12, 4, 19, 44, 30, 134, 44, 25, 29, 28, 22, 78, 114, 15, 20, 59, 17, 32, 29, 20, 1]
[1, 1, 1, 2, 12, 50, 17, 129, 20, 13, 33, 42, 9, 20, 187, 24, 36, 22, 19, 140, 14, 1, 1, 1, 1, 1, 1, 1, 1, 1]
[1, 1, 1, 2, 68, 31, 46, 12, 29, 173, 27, 33, 1, 12, 58, 12, 18, 26, 218, 10, 25, 141, 32, 20, 138, 20, 3, 2, 112, 26, 155, 19, 32, 4, 12, 317, 110, 3]
[1, 1, 1, 1, 2, 23, 26, 50, 28, 45, 36, 100, 19, 167, 36, 31, 185, 19, 17, 13, 1]
[1, 42, 26, 5, 15, 49, 89, 13, 81, 16, 19, 165, 13, 14, 145, 29, 27, 17, 45, 12, 1, 7, 177, 8, 248, 6, 10, 147, 157, 7, 23, 3, 34, 35, 5, 3, 383]

