[2, 4, 14, 17, 1, 1, 1, 1]
[2, 19, 37, 12, 47, 18, 14, 3, 48, 99, 11, 17, 39, 14, 4, 127, 6, 5, 33, 8, 59, 101, 1, 68, 62, 59, 31, 9, 150]
[2, 3, 2, 3, 34, 1]
[2, 4, 3, 26, 11, 26, 19, 12, 11, 40, 27, 5, 14, 16, 160, 7, 100, 102, 17, 7, 1, 1]
[2, 3, 3, 10, 63, 55, 59, 66, 15, 17, 192, 16, 48, 24, 15, 15, 40, 198, 175, 1, 1]
[1, 1, 2, 4, 10, 52, 8, 55, 10, 11, 21, 17, 42, 35, 165, 18, 4, 2, 1]
[4, 11, 50, 8, 65, 13, 45, 81, 170, 7, 41, 10, 147, 1, 17, 35, 16, 159, 32]
[1, 1, 4, 10, 55, 14, 1, 42, 26, 10, 1, 11, 18, 6, 149, 13, 6, 52, 23, 24, 35, 3, 3, 2, 227, 21, 147, 94, 10, 6]
[2, 1, 4, 8, 55, 10, 1, 2, 14, 46, 22, 86, 21, 30, 1, 1, 1]



