[2, 1, 2, 4, 18, 30, 40, 20, 43, 60, 27, 49, 22, 73, 63, 48, 8, 135, 73]
[2, 1, 1, 1, 4, 5, 59, 3, 37, 19, 20, 35, 61, 62, 49, 20, 13, 186, 13]
[2, 1, 4, 2, 53, 11, 9, 61, 33, 31, 22, 47, 52, 16, 129, 51]
[2, 1, 1, 1, 4, 38, 48, 39, 40, 66, 54, 50, 65, 13, 12, 13, 199]
[2, 4, 2, 56, 24, 30, 23, 94, 28, 78, 54, 23, 19, 12, 159, 28]
[2, 1, 1, 1, 2, 4, 68, 10, 9, 29, 51, 13, 77, 46, 7, 33, 8, 51, 161, 59, 16]
[2, 1, 1, 1, 4, 2, 52, 34, 55, 15, 136, 67, 41, 21, 20, 53]
[2, 1, 1, 2, 3, 2, 16, 36, 2, 12, 14, 56, 25, 6, 57, 4, 73, 63, 36, 46, 2, 1, 2]
[2, 1, 1, 2, 19, 40, 16, 43, 10, 112, 21, 39, 89, 13, 64, 18, 5]
[2, 1, 1, 1, 2, 4, 3, 47, 42, 9, 102, 37, 79, 9, 48, 64, 66, 28, 14, 35]


